1111111111111
1M0100C000001
1C00011111001
1P0011E000001
1111111111111