111111111
1E0C000C1
10000P001
111111111
111111111
111111111
111111111
111111111
111111111
111111111