111111111111111
1001000000000C1
100001111111M01
100011E00000001
1PY010000000001
1001000000000C1
111111111111111