1111111111111
1M01000000001
1C00011111001
100011E000001
1111111111111