111111111111
1E0C000C1111
10000P001111
111111111111