111111111111111
1001000000000C1
100001101M11111
100011E00000001
1P0010000000001
1001000000000C1
111111111111111