11111111111111111111
1PO                1
1                  1
1                  1
1                  1
1             E    1
1                  1
1                  1
1                  1
1               C  1
1                  1
1                  1
1                  1
1                  1
1                  1
1               C  1
1                  1
1                  1
11111111111111111111